1111111111111111111111111111111
1000010000100001000010000100001
1000010000100001000010000100001
1000010000100001000010000100001
1000000000100000000010000000001
1111000111111100011111110001111
1000000000100000000010000000001
1000010000100001000010000100001
1000010000100001000010000100001
1000010000000001000000000100001
1111111110001111111000111111111
1000010000000001000000000100001
1000010000100001000010000100001
1000010000100001000010000100001
1000000000100000000010000000001
1111000111111100011111110001111
1000000000100000000010000000001
1000010000100001000010000100001
1000010000100001000010000100001
1000010000000001000000000100001
1111111110001111111000111111111
1000010000000001000000000100001
1000010000100001000010000100001
1000010000100001000010000100001
1000000000100000000010000000001
1111000111111100011111110001111
1000000000100000000010000000001
1000010000100001000010000100001
1000010000100001000010000100001
1000010000100001000010000100001
1111111111111111111111111111111
