1111111111111111111111111111111
1000000000100000000010000000001
1000000000100000000010000000001
1000000000100000000010000000001
1000000000100000000010000000001
1000000000000000000000000000001
1000000000100000000010000000001
1000000000100000000010000000001
1000000000100000000010000000001
1000000000100000000010000000001
1111101111111010101111111011111
1000000000100000000010000000001
1000000000100000000010000000001
1000000000000101010000000000001
1000000000100000000010000000001
1000000000000100010000000000001
1000000000100000000010000000001
1000000000000101010000000000001
1000000000100000000010000000001
1000000000100000000010000000001
1111101111111010101111111011111
1000000000100000000010000000001
1000000000100000000010000000001
1000000000100000000010000000001
1000000000100000000010000000001
1000000000000000000000000000001
1000000000100000000010000000001
1000000000100000000010000000001
1000000000100000000010000000001
1000000000100000000010000000001
1111111111111111111111111111111